Name	Partei	Beruf
Abdi, Sanae	SPD	Vertrags- und Finanzmanagerin
Abel, Valentin	FDP	Kaufmännischer Angestellter
Abraham, Knut	CDU/CSU	Diplomat
Adler, Katja	FDP	Beamtin
Aeffner, Stephanie	Grüne	Landes-Behindertenbeauftragte
Ahmetovic, Adis	SPD	Angestellter
Akbulut, Gökay	Die Linke	Sozialwissenschaftlerin
Alabali-Radovan, Reem	SPD	Integrationsbeauftragte
Albani, Stephan	CDU/CSU	Diplom-Physiker
Al-Dailami, Ali	Die Linke	Angestellter
Al-Halak, Muhanad	FDP	Abwassermeister
Altenkamp, Norbert	CDU/CSU	Diplom-Volkswirt
Alt, Renata	FDP	Diplom-Ingenieurin Chemie
Amthor, Philipp	CDU/CSU	Jurist
Amtsberg, Luise	Grüne	Islamwissenschaftlerin
Andres, Dagmar	SPD	Referentin
Annen, Niels	SPD	Politikwissenschaftler (M.I.P.P.)
Arlt, Johannes	SPD	Berufsoffizier
Aschenberg-Dugnus, Christine	FDP	Rechtsanwältin
Audretsch, Andreas	Grüne	Sozialwissenschaftler
Auernhammer, Artur	CDU/CSU	Landwirtschaftsmeister, staatlich geprüfter Landwirt
Aumer, Peter	CDU/CSU	Diplom-Betriebswirt (FH)
Außendorf, Maik	Grüne	IT-Unternehmer
Bacherle, Tobias	Grüne	Student
Bachmann, Carolin	AfD	Wissenschaftliche Mitarbeiterin
Badum, Lisa	Grüne	Politikwissenschaftlerin
Baehrens, Heike	SPD	Diakonin
Baerbock, Annalena	Grüne	Völkerrechtlerin, LL.M.
Bahr, Ulrike	SPD	Hauptschullehrerin
Baldy, Daniel	SPD	Lehrer
Banaszak, Felix	Grüne	Sozial- und Kulturanthropologe
Baradari, Nezahat	SPD	Fachärztin für Kinder- und Jugendmedizin
Bär, Dorothee	CDU/CSU	Diplom-Politologin
Bareiß, Thomas	CDU/CSU	Diplom-Betriebswirt (BA)
Bär, Karl	Grüne	Agrarökonom
Bartol, Sören	SPD	Diplom-Politologe
Bartsch, Dr. Dietmar	Die Linke	Wirtschaftswissenschaftler
Bas, Bärbel	SPD	Personalmanagement-Ökonomin (VWA)
Bauer, Nicole	FDP	Diplom-Wirtschaftsingenieurin (FH)
Baumann, Dr. Bernd	AfD	Kaufmann
Baum, Dr. Christina	AfD	Zahnärztin
Bayram, Canan	Grüne	Rechtsanwältin
Beckamp, Roger	AfD	Rechtsanwalt
Becker, Dr. Holger	SPD	Physiker / wissenschaftlicher Leiter
Beck, Katharina	Grüne	Unternehmensberaterin für Nachhaltigkeit
Beeck, Jens	FDP	Rechtsanwalt
Benner, Lukas	Grüne	Jurist
Berghahn, Jürgen	SPD	Elektroinstallateur
Berghegger, Dr. André	CDU/CSU	Jurist
Bergt, Bengt	SPD	Redakteur
Bernhard, Marc	AfD	Rechtsanwalt, MBA
Beyer, Peter	CDU/CSU	Rechtsanwalt
Biadacz, Marc	CDU/CSU	Sozialwissenschaftler (M.A.)
Bilger, Steffen	CDU/CSU	Volljurist
Birkwald, Matthias W.	Die Linke	Diplom-Sozialwissenschaftler
Blankenburg, Jakob	SPD	Politikwissenschaftler
Bleck, Andreas	AfD	Student
Bochmann, René	AfD	Bürokaufmann
Bodtke, Ingo	FDP	Ingenieur Fleischwirtschaft
Boehringer, Peter	AfD	Diplom-Kaufmann, Diplom-Informatiker
Boginski, Friedhelm	FDP	Lehrer
Bollmann, Gereon	AfD	Richter a. D.
Borchardt, Simone	CDU/CSU	Geschäftsbereichsleiterin Pflege
Brandenburg (Rhein-Neckar), Dr. Jens	FDP	Unternehmensberater
Brandenburg (Südpfalz), Mario	FDP	Wirtschaftsinformatiker (M.Sc.)
Brandes, Dirk	AfD	Verwaltungsangestellter
Brand (Fulda), Michael	CDU/CSU	Politikwissenschaftler (M.A.)
Brandl, Dr. Reinhard	CDU/CSU	Diplom-Wirtschaftsingenieur
Brandner, Stephan	AfD	Rechtsanwalt
Brantner, Dr. Franziska	Grüne	Sozialwissenschaftlerin
Braun, Jürgen	AfD	Kommunikationsberater
Braun, Prof. Dr. Helge	CDU/CSU	Arzt
Breher, Silvia	CDU/CSU	Rechtsanwältin, Volljuristin
Brehmer, Heike	CDU/CSU	Diplom-Betriebswirtin (FH)
Brehm, Sebastian	CDU/CSU	Steuerberater 
Breilmann, Michael	CDU/CSU	Rechtsanwalt
Breymaier, Leni	SPD	Einzelhandelskauffrau
Brinkhaus, Ralph	CDU/CSU	Steuerberater
Brodesser, Dr. Carsten	CDU/CSU	Diplom-Volkswirt
Bröhr, Dr. Marlon	CDU/CSU	Zahnarzt
Brugger, Agnieszka	Grüne	Studentin
Bsirske, Frank	Grüne	Rentner
Bubendorfer-Licht, Sandra	FDP	Dolmetscherin
Budde, Katrin	SPD	Diplom-Ingenieurin für Arbeitsgestaltung
Bühl, Marcus	AfD	Diplom-Informatiker (M. Sc.) (FH)
Bury, Yannick	CDU/CSU	Volkswirt
Buschmann, Dr. Marco	FDP	Rechtsanwalt
Busen, Karlheinz	FDP	Bauingenieur
Bystron, Petr	AfD	Diplom-Politologe
Cademartori Dujisin, Isabel	SPD	Wirtschaftspädagogin
Castellucci, Prof. Dr. Lars	SPD	Hochschulprofessor
Christmann, Dr. Anna	Grüne	Politikwissenschaftlerin
Chrupalla, Tino	AfD	selbständiger Malermeister
Connemann, Gitta	CDU/CSU	Verkäuferin, Rechtsanwältin
Coße, Jürgen	SPD	Arbeitsvermittler
Cotar, Joana	AfD	
Cronenberg, Carl-Julius	FDP	Betriebswirt
Curio, Dr. Gottfried	AfD	Diplom-Mathematiker, Diplom-Physiker
Czaja, Mario	CDU/CSU	Betriebswirt
Dağdelen, Sevim	Die Linke	Journalistin
Dahmen, Dr. Janosch	Grüne	Arzt/ Medizinaldirektor a. D. 
Daldrup, Bernhard	SPD	
Damerow, Astrid	CDU/CSU	Bankkauffrau
Deligöz, Ekin	Grüne	Diplom-Verwaltungswissenschaftlerin
Demir, Hakan	SPD	wissenschaftlicher Mitarbeiter im Deutschen Bundestag
Detzer, Dr. Sandra	Grüne	Politikwissenschaftlerin
Diaby, Dr. Karamba	SPD	Diplom-Chemiker
Diedenhofen, Martin	SPD	Student
Dieren, Jan	SPD	Rechtsanwalt
Dietz, Thomas	AfD	Buchdrucker
Dilcher, Esther	SPD	Rechtsanwältin und Notarin
Dittmar, Sabine	SPD	Ärztin
Djir-Sarai, Bijan	FDP	Diplom-Kaufmann
Dobrindt, Alexander	CDU/CSU	Diplom-Soziologe
Domscheit-Berg, Anke	Die Linke	Publizistin
Donth, Michael	CDU/CSU	Diplom-Verwaltungswirt
Döring, Felix	SPD	Lehrer
Dröge, Katharina	Grüne	Diplom-Volkswirtin
Droßmann, Falko	SPD	Oberstleutnant der Luftwaffe
Düring, Deborah	Grüne	Studentin
Dürr, Christian	FDP	Diplom-Ökonom
Durz, Hansjörg	CDU/CSU	Diplom-Kaufmann
Ebner, Harald	Grüne	Diplom-Agraringenieur
Echeverria, Axel	SPD	Angestellter
Eckert, Leon	Grüne	Kommunalreferent
Edelhäußer, Ralph	CDU/CSU	Erster Bürgermeister
Ehrhorn, Thomas	AfD	Pilot
Eichwede, Sonja	SPD	Richterin
Emmerich, Marcel	Grüne	Wissenschaftlicher Referent
Engelhard, Alexander	CDU/CSU	Müller, Diplom-Wirtschaftsingenieur (FH)
Engelhardt, Heike	SPD	Redakteurin
Englhardt-Kopf, Martina	CDU/CSU	Studiendirektorin
Erndl, Thomas	CDU/CSU	Elektroingenieur
Ernst, Klaus	Die Linke	Diplom-Volkswirt, Diplom-Sozialökonom
Esdar, Dr. Wiebke	SPD	Diplom-Psychologin
Esken, Saskia	SPD	Informatikerin
Espendiller, Dr. Michael	AfD	Mathematiker
Faber, Dr. Marcus	FDP	Politologe
Fahimi, Yasmin	SPD	Diplom-Chemikerin
Färber, Hermann	CDU/CSU	Landwirtschaftsmeister
Farle, Robert	AfD	Rechtsanwalt,  Steuerberater
Fäscher, Ariane	SPD	Pressesprecherin
Fechner, Dr. Johannes	SPD	
Feiler, Uwe	CDU/CSU	Diplom-Finanzwirt
Felser, Peter	AfD	Diplom-Pädagoge
Ferlemann, Enak	CDU/CSU	
Ferschl, Susanne	Die Linke	Chemielaborantin/Wirtschaftsmediatorin
Fester, Emilia	Grüne	Regieassistentin
Fiedler, Sebastian	SPD	Kriminalbeamter
Föst, Daniel	FDP	
Franke, Dr. Edgar	SPD	Jurist
Frei, Thorsten	CDU/CSU	
Fricke, Otto	FDP	Rechtsanwalt
Friedhoff, Dietmar	AfD	Diplom-Ingenieur / Vertriebstrainer
Friedrich (Hof), Dr. Hans-Peter	CDU/CSU	Rechtsanwalt
Frieser, Michael	CDU/CSU	Rechtsanwalt
Frohnmaier, Markus	AfD	Pressesprecher
Frömming, Dr. Götz	AfD	Gymnasiallehrer
Funke, Fabian	SPD	Internationale Beziehungen (B. A.)
Funke-Kaiser, Maximilian	FDP	Betriebswirt
Gädechens, Ingo	CDU/CSU	
Gambir, Schahina	Grüne	Politikwissenschaftlerin
Ganserer, Tessa	Grüne	Diplom-Ingenieurin Wald- und Forstwirtschaft
Gaßner-Herz, Martin	FDP	Verwaltungsangestellter
Gastel, Matthias	Grüne	
Gauland, Dr. Alexander	AfD	Publizist
Gava, Manuel	SPD	Vertriebsleiter
Gebhart, Dr. Thomas	CDU/CSU	
Gehring, Kai	Grüne	Diplom-Sozialwissenschaftler
Geissler, Dr. Jonas	CDU/CSU	Regierungsrat
Gelbhaar, Stefan	Grüne	Rechtsanwalt
Gerdes, Michael	SPD	Elektrohauer
Gerschau, Knut	FDP	Geschäftsführer
Gerster, Martin	SPD	
Gesenhues, Dr. Jan-Niclas	Grüne	Volkswirt
Glaser, Albrecht	AfD	Jurist
Glöckner, Angelika	SPD	Verwaltungsfachwirtin, Betriebswirtin
Gnauck, Hannes	AfD	Soldat auf Zeit
Gohlke, Nicole	Die Linke	Sozialwissenschaftlerin
Göring-Eckardt, Katrin	Grüne	
Görke, Christian	Die Linke	
Gottschalk, Kay	AfD	Diplom-Kaufmann, Bankkaufmann
Gramling, Fabian	CDU/CSU	Bankkaufmann (M. A.)
Gräßle, Dr. Ingeborg	CDU/CSU	Journalistin
Grau, Prof. Dr. Armin	Grüne	Arzt
Gremmels, Timon	SPD	Diplom-Politologe
Griese, Kerstin	SPD	Historikerin/Politikwissenschaftlerin
Gröhe, Hermann	CDU/CSU	Jurist
Grosse-Brömer, Michael	CDU/CSU	Rechtsanwalt
Grötsch, Ulrich	SPD	Polizeibeamter
Grübel, Markus	CDU/CSU	Notar
Grundl, Erhard	Grüne	
Grund, Manfred	CDU/CSU	Diplom-Elektroingenieur
Grundmann, Oliver	CDU/CSU	Rechtsanwalt
Grütters, Prof. Monika	CDU/CSU	Literatur- und Kunsthistorikerin
Grützmacher, Sabine	Grüne	Sozialpädagogin
Güler, Serap	CDU/CSU	Beamtin
Güntzler, Fritz	CDU/CSU	Wirtschaftsprüfer, Steuerberater
Gürpinar, Ates	Die Linke	Medienwissenschaftler
Gutting, Olav	CDU/CSU	Rechtsanwalt
Gysi, Dr. Gregor	Die Linke	Rechtsanwalt
Haase, Christian	CDU/CSU	Diplom-Verwaltungswirt
Habeck, Dr. Robert	Grüne	Politiker
Hacker, Thomas	FDP	Diplom-Kaufmann
Hagedorn, Bettina	SPD	Goldschmiedin
Hagl-Kehl, Rita	SPD	Gymnasiallehrerin
Hahn, Dr. André	Die Linke	
Hahn, Florian	CDU/CSU	Electronic Marketing Fachwirt (BAW)
Hakverdi, Metin	SPD	Volljurist
Hanke, Reginald	FDP	Malermeister
Harder-Kühnel, Mariana Iris	AfD	Rechtsanwältin
Hardt, Jürgen	CDU/CSU	Diplom-Volkswirt
Hartewig, Philipp	FDP	Jurist
Hartmann, Sebastian	SPD	
Harzer, Ulrike	FDP	Geschäftsführerin
Haßelmann, Britta	Grüne	Diplom-Sozialarbeiterin
Hauer, Matthias	CDU/CSU	Rechtsanwalt
Haug, Jochen	AfD	Rechtsanwalt
Heck, Dr. Stefan	CDU/CSU	Staatssekretär im Ministerium des Innern und für Sport
Heidenblut, Dirk	SPD	Geschäftsführer
Heidt, Peter	FDP	Rechtsanwalt
Heiligenstadt, Frauke	SPD	Dipl.-Verwaltungswirtin
Heilmann, Thomas	CDU/CSU	Volljurist
Heil, Mechthild	CDU/CSU	Diplom-Ing. Architektin
Heil (Peine), Hubertus	SPD	Politikwissenschaftler
Heinrich, Gabriela	SPD	Redakteurin
Heitmann, Linda	Grüne	Geschäftsführerin in der Suchtkrankenhilfe
Helferich, Matthias	fraktionslos	Rechtsanwalt
Helfrich, Mark	CDU/CSU	Diplom-Kaufmann (FH)
Helling-Plahr, Katrin	FDP	Rechtsanwältin
Hellmich, Wolfgang	SPD	
Henneberger, Kathrin	Grüne	Projektkoordinatorin
Hennig, Anke	SPD	Qualifizierte Kindertagespflegeperson
Hennig-Wellsow, Susanne	Die Linke	Diplom-Pädagogin
Hennrich, Michael	CDU/CSU	
Henrichmann, Marc	CDU/CSU	Rechtsanwalt
Herbrand, Markus	FDP	Diplom-Finanzwirt (FH) / Steuerberater
Herbst, Torsten	FDP	Diplom-Kaufmann (FH)
Herrmann, Bernhard	Grüne	Diplom-Wasserbauingenieur
Heselhaus, Nadine	SPD	Verwaltungsbeamtin
Hessel, Katja	FDP	Rechtsanwältin
Hess, Martin	AfD	Polizeibeamter
Heveling, Ansgar	CDU/CSU	Jurist
Hierl, Susanne	CDU/CSU	Rechtsanwältin
Hilse, Karsten	AfD	Polizeibeamter
Hirte, Christian	CDU/CSU	Rechtsanwalt / Fachanwalt für Steuerrecht
Hitschler, Thomas	SPD	
Höchst, Nicole	AfD	Lehrerin
Hocker, Dr. Gero Clemens	FDP	Wirtschaftswissenschaftler
Höferlin, Manuel	FDP	IT-Unternehmer
Hoffmann, Alexander	CDU/CSU	Jurist
Hoffmann, Dr. Bettina	Grüne	Diplom-Biologin
Hoffmann, Dr. Christoph	FDP	Diplom-Forstwissenschaftler
Hofreiter, Dr. Anton	Grüne	Diplom-Biologe
Holm, Leif-Erik	AfD	Ökonom (M. Sc.)
Hönel, Bruno	Grüne	Psychologiestudent
Hoppenstedt, Dr. Hendrik	CDU/CSU	Jurist
Hoppermann, Franziska	CDU/CSU	leitende Regierungsdirektorin
Hostert, Jasmina	SPD	Politikwissenschaftlerin
Houben, Reinhard	FDP	Unternehmer
Huber, Johannes	AfD	Diplom-Soziologe, Finanzbuchhalter
Hubertz, Verena	SPD	Gründerin und Unternehmerin
Hümpfer, Markus	SPD	Ingenieur
Hunko, Andrej	Die Linke	Mediengestalter
Hüppe, Hubert	CDU/CSU	Diplom-Verwaltungswirt
Huy, Gerrit	AfD	Diplom-Mathematikerin
in der Beek, Olaf	FDP	
Irlstorfer, Erich	CDU/CSU	
Jacobi, Fabian	AfD	Rechtsanwalt
Janecek, Dieter	Grüne	Politikwissenschaftler
Janich, Steffen	AfD	Polizeibeamter
Janssen, Anne	CDU/CSU	Lehrerin
Jarzombek, Thomas	CDU/CSU	IT-Berater
Jensen, Gyde	FDP	Politikwissenschaftlerin (M.A.)
Jongen, Dr. Marc	AfD	Dozent für Philosophie
Jung, Andreas	CDU/CSU	
Junge, Frank	SPD	Diplom-Sportlehrer
Jung, Ingmar	CDU/CSU	
Juratovic, Josip	SPD	Kfz-Mechaniker
Jurisch, Dr. Ann-Veruschka	FDP	Juristin
Kaczmarek, Oliver	SPD	Sozialwissenschaftler
Kaddor, Lamya	Grüne	Islamwissenschaftlerin
Kaiser, Elisabeth	SPD	Politik- und Verwaltungswissenschaftlerin 
Kappert-Gonther, Dr. Kirsten	Grüne	Ärztin
Karaahmetoğlu, Macit	SPD	Rechtsanwalt
Karliczek, Anja	CDU/CSU	Diplom-Kauffrau
Kasper, Carlos	SPD	Zollbeamter
Kassautzki, Anna	SPD	Staatswissenschaftlerin
Katzmarek, Gabriele	SPD	Gewerkschaftssekretärin
Kaufmann, Dr. Malte	AfD	Diplom-Volkswirt
Kaufmann, Prof. Dr. Michael	AfD	Ingenieur
Keller, Rainer Johannes	SPD	Krankenpfleger und Notfallsanitäter
Kellner, Michael	Grüne	Bundesgeschäftsführer
Kemmer, Ronja	CDU/CSU	Volkswirtin
Kersten, Dr. Franziska	SPD	Tierärztin
Keul, Katja	Grüne	Rechtsanwältin
Keuter, Stefan	AfD	Bankkaufmann, Diplom-Betriebswirt (FH)
Khan, Misbah	Grüne	Landesvorsitzende
Kiesewetter, Roderich	CDU/CSU	Diplom-Kaufmann
Kießling, Michael	CDU/CSU	Diplom-Bauingenieur (FH)
Kindler, Sven-Christian	Grüne	Betriebswirt
Kippels, Dr. Georg	CDU/CSU	Rechtsanwalt
Kipping, Katja	Die Linke	Literaturwissenschaftlerin
Kiziltepe, Cansel	SPD	Diplom-Volkswirtin
Kleebank, Helmut	SPD	Krankenpfleger, Lehrer
Klein, Dr. Ottilie	CDU/CSU	Abteilungsdirektorin
Klein, Karsten	FDP	Diplom-Kaufmann
Klein-Schmeink, Maria	Grüne	Soziologin
Klein, Volkmar	CDU/CSU	Diplom-Volkswirt
Kleinwächter, Norbert	AfD	Lehrer
Klinck, Dr. Kristian	SPD	Studienrat
Klingbeil, Lars	SPD	Politikwissenschaftler
Klöckner, Julia	CDU/CSU	Chefredakteurin
Klose, Annika	SPD	Sozialwissenschaftlerin
Kluckert, Daniela	FDP	Diplom-Volkswirtin
Klüssendorf, Tim	SPD	Volks- und Betriebswirt
Knoerig, Axel	CDU/CSU	Politik- und Kommunikationswissenschaftler
Kober, Pascal	FDP	Militärseelsorger
Koeppen, Jens	CDU/CSU	Elektromeister
Kofler, Dr. Bärbel	SPD	Sprachwissenschaftlerin
Köhler, Dr. Lukas	FDP	Philosoph
Komning, Enrico	AfD	Rechtsanwalt
König, Anne	CDU/CSU	Gesamtschulrektorin
König, Jörn	AfD	Diplom-Ingenieur (MBA)
Konrad, Carina	FDP	Diplom-Ingenieurin (FH)
Koob, Markus	CDU/CSU	
Kopf, Chantal	Grüne	Politikwissenschaftlerin
Körber, Carsten	CDU/CSU	Wirtschafts- und Unternehmensberater
Korte, Jan	Die Linke	Politikwissenschaftler (M. A.)
Koß, Simona	SPD	Lehrerin
Kotré, Steffen	AfD	Diplom-Ingenieur
Kraft, Dr. Rainer	AfD	Diplom-Chemiker
Kraft, Laura	Grüne	wiss. Mitarbeiterin
Krämer, Philip	Grüne	Politiker
Kramme, Anette	SPD	
Kreiser, Dunja	SPD	Abwassermeisterin
Krichbaum, Gunther	CDU/CSU	
Krings, Dr. Günter	CDU/CSU	Jurist
Krischer, Oliver	Grüne	
Kröber, Martin	SPD	Geschäftsstellenleiter
Kruse, Michael	FDP	Unternehmer
Kuban, Tilman Moritz	CDU/CSU	Rechtsanwalt
Kubicki, Wolfgang	FDP	Rechtsanwalt / Diplom-Volkswirt
Kuhle, Konstantin	FDP	Rechtsanwalt
Kühnert, Kevin	SPD	Angestellter
Kühn (Tübingen), Christian	Grüne	Politologe
Künast, Renate	Grüne	Rechtsanwältin
Kurth, Markus	Grüne	Politikwissenschaftler
Lahrkamp, Sarah	SPD	Politikwissenschaftlerin
Lambsdorff, Alexander Graf	FDP	Diplomat
Lange, Ulrich	CDU/CSU	Rechtsanwalt
Lang, Ricarda	Grüne	Angestellte
Larem, Andreas	SPD	Groß- und Außenhandelskaufmann/ Bürgermeister
Laschet, Armin	CDU/CSU	Ministerpräsident a. D.
Latendorf, Ina	Die Linke	Juristin
Launert, Dr. Silke	CDU/CSU	
Lauterbach, Prof. Dr. Karl	SPD	
Lay, Caren	Die Linke	Diplom-Soziologin
Lechte, Ulrich	FDP	Betriebswirt (VWA)
Lehmann, Jens	CDU/CSU	Erzieher
Lehmann, Sven	Grüne	Politikwissenschaftler
Lehmann, Sylvia	SPD	Ingenieurökonomin
Lehrieder, Paul	CDU/CSU	Rechtsanwalt
Leikert, Dr. Katja	CDU/CSU	
Leiser, Kevin	SPD	Lehrer
Lemke, Steffi	Grüne	Diplom-Agraringenieurin
Lenders, Jürgen	FDP	Kaufmann
Lenk, Barbara	AfD	Bibliothekarin
Lenkert, Ralph	Die Linke	Maschinenbautechniker
Lenz, Dr. Andreas	CDU/CSU	
Leye, Christian	Die Linke	Ökonom
Licina-Bode, Luiza	SPD	Beamtin
Lieb, Dr. Thorsten	FDP	Rechtsanwalt
Liebert, Anja	Grüne	Verwaltungsangestellte
Limbacher, Esra-Leon	SPD	Jurist
Limburg, Helge	Grüne	Jurist
Lindemann, Lars	FDP	Rechtsanwalt
Lindh, Helge	SPD	Wissenschaftlicher Mitarbeiter
Lindholz, Andrea	CDU/CSU	Rechtsanwältin
Lindner, Christian	FDP	Politikwissenschaftler
Lindner, Dr. Tobias	Grüne	Wirtschaftswissenschaftler
Link, Michael Georg	FDP	Übersetzer
Linnemann, Dr. Carsten	CDU/CSU	Diplom-Volkswirt
Lips, Patricia	CDU/CSU	Handelsfachwirtin
Loop, Denise	Grüne	Sozialarbeiterin
Loos, Bernhard	CDU/CSU	Wirtschafts- und Politikwissenschaftler
Lötzsch, Dr. Gesine	Die Linke	Philologin
Lucassen, Rüdiger	AfD	Diplom-Kaufmann
Lucks, Max	Grüne	Angestellter
Luczak, Dr. Jan-Marco	CDU/CSU	Rechtsanwalt
Ludwig, Daniela	CDU/CSU	
Lugk, Bettina	SPD	Geowissenschaftlerin
Lührmann, Dr. Anna	Grüne	Politikwissenschaftlerin
Luksic, Oliver	FDP	Unternehmensberater
Lütke, Kristine	FDP	Pflegeunternehmerin
Lutze, Thomas	Die Linke	Maschinenbauer, Bürokaufmann
Maas, Heiko	SPD	Jurist
Machalet, Dr. Tanja	SPD	Diplom-Volkswirtin
Mackensen-Geis, Isabel	SPD	Politikwissenschaftlerin
Mack, Klaus	CDU/CSU	Diplom-Verwaltungswirt (FH)
Magwas, Yvonne	CDU/CSU	Diplom-Soziologin
Malottki, Erik von	SPD	Gewerkschafter
Mann, Holger	SPD	Mitglied des Landtages
Mansmann, Till	FDP	Diplom-Physiker
Mansoori, Kaweh	SPD	Rechtsanwalt
Martens, Zanda	SPD	Gewerkschaftssekretärin
Martin, Dorothee	SPD	Diplom-Politologin
Marvi, Parsa	SPD	Produktmanager Breitband
Mascheck, Franziska	SPD	Sozialarbeiterin
Mast, Katja	SPD	
Mattfeldt, Andreas	CDU/CSU	Industriekaufmann
Mayer (Altötting), Stephan	CDU/CSU	Rechtsanwalt
Mayer-Lay, Volker	CDU/CSU	Rechtsanwalt, Mediator
Mayer, Zoe	Grüne	Wirtschaftsingenieurin
Mehltretter, Andreas	SPD	Volkswirt
Mehmet Ali, Takis	SPD	Verwaltungsleiter
Meiser, Pascal	Die Linke	Diplom-Politikwissenschaftler
Meister, Dr. Michael	CDU/CSU	Diplom-Mathematiker
Menge, Susanne	Grüne	Studienrätin
Merten, Anikó	FDP	Kunstwissenschaftlerin
Merz, Friedrich	CDU/CSU	Rechtsanwalt
Mesarosch, Robin	SPD	parl. Referent
Metzler, Jan	CDU/CSU	Winzer, Diplom-Betriebswirt (FH)
Meyer, Christoph	FDP	Rechtsanwalt
Miazga, Corinna	AfD	Angestellte
Michaelsen, Swantje Henrike	Grüne	Geschäftsstellenleitung
Michel, Kathrin	SPD	Teamleiterin
Middelberg, Dr. Mathias	CDU/CSU	Rechtsanwalt
Miersch, Dr. Matthias	SPD	Rechtsanwalt
Mieves, Matthias David	SPD	Diplom-Kaufmann
Mihalic, Dr. Irene	Grüne	Polizeibeamtin
Mijatović, Boris	Grüne	Angestellter
Mittag, Susanne	SPD	Polizeibeamtin
Mohamed Ali, Amira	Die Linke	Rechtsanwältin
Möhring, Cornelia	Die Linke	Diplom-Sozialökonomin
Mohrs, Falko	SPD	Diplom-Kaufmann (FH)
Moll, Claudia	SPD	Altenpflegerin
Möller, Siemtje	SPD	Lehrerin 
Moncsek, Mike	AfD	Angestellter
Monstadt, Dietrich	CDU/CSU	Rechtsanwalt
Moosdorf, Matthias	AfD	Musiker
Mordhorst, Maximilian	FDP	Student
Mörseburg, Maximilian	CDU/CSU	Rechtsanwalt
Müller, Alexander	FDP	Diplom-Informatiker
Müller, Axel	CDU/CSU	Richter
Müller, Bettina	SPD	
Müller (Braunschweig), Carsten	CDU/CSU	Bankkaufmann / Rechtsanwalt
Müller (Chemnitz), Detlef	SPD	Lokomotivführer
Müller, Claudia	Grüne	Betriebswirtin
Müller (Erlangen), Stefan	CDU/CSU	
Müller, Florian	CDU/CSU	Referent für Strategie und Regulierung
Müller-Gemmeke, Beate	Grüne	Diplom-Sozialpädagogin (FH)
Müller, Michael	SPD	
Müller-Rosentritt, Frank	FDP	Diplom-Betriebswirt
Müller, Sascha	Grüne	Sportjournalist
Müller, Sepp	CDU/CSU	Diplomierter Bankbetriebswirt
Müntefering, Michelle	SPD	Journalistin
Münzenmaier, Sebastian	AfD	Versicherungs- und Finanzanlagenfachmann
Mützenich, Dr. Rolf	SPD	Politikwissenschaftler
Nacke, Dr. Stefan	CDU/CSU	
Nanni, Sara	Grüne	Friedens- und Konfliktforscherin
Nasr, Rasha	SPD	Büroleiterin
Nastic, Zaklin	Die Linke	
Naujok, Edgar	AfD	Unternehmer
Nestle, Dr. Ingrid	Grüne	Diplom-Wirtschaftsingenieurin
Nick, Dr. Ophelia	Grüne	Tierärztin
Nickholz, Brian	SPD	Geschäftsführer
Nicolaisen, Petra	CDU/CSU	Industriekauffrau
Nietan, Dietmar	SPD	
Nolte, Jan Ralf	AfD	Soldat
Notz, Dr. Konstantin von	Grüne	Rechtsanwalt
Nouripour, Omid	Grüne	selbständig
Nürnberger, Jörg	SPD	Rechtsanwalt
Oehl, Lennard	SPD	Volkswirt
Oellers, Wilfried	CDU/CSU	Rechtsanwalt
Oppelt, Moritz	CDU/CSU	Jurist
Ortleb, Josephine	SPD	Fachwirtin im Gastgewerbe
Oßner, Florian	CDU/CSU	Diplom-Volkswirt (Univ.)
Oster, Josef	CDU/CSU	Diplom-Verwaltungswirt (FH)
Otte, Henning	CDU/CSU	Jurist, Prokorist
Otte, Karoline	Grüne	Verwaltungsbetriebswirtin
Otten, Gerold	AfD	Berufssoldat a.D.
Pahlke, Julian	Grüne	Referent
Pantazis, Dr. Christos	SPD	Arzt
Papenbrock, Wiebke	SPD	Referentin
Papendieck, Mathias	SPD	Informatiker
Pau, Petra	Die Linke	Lehrerin
Paus, Lisa	Grüne	Diplom-Volkswirtin
Pawlik, Natalie	SPD	ltd. Angestellte
Peick, Jens	SPD	Dipl.-Verwaltungswirt (FH)
Pellmann, Sören	Die Linke	Grund- und Förderschullehrer
Perli, Victor	Die Linke	Politikwissenschaftler
Peterka, Tobias Matthias	AfD	Diplom-Jurist
Petry, Christian	SPD	Diplom-Verwaltungswirt
Philippi, Dr. Andreas	SPD	Facharzt Chirurgie
Piechotta, Dr. med. Paula	Grüne	Ärztin
Pilsinger, Stephan	CDU/CSU	Arzt
Plobner, Jan	SPD	Standesbeamter
Ploß, Dr. Christoph	CDU/CSU	Historiker
Plum, Dr. Martin	CDU/CSU	Richter
Pohl, Jürgen	AfD	Rechtsanwalt
Polat, Filiz	Grüne	Diplom-Volkswirtin
Poschmann, Sabine	SPD	Betriebswirtin (VWA)
Post (Minden), Achim	SPD	Diplom-Soziologe
Protschka, Stephan	AfD	
Rachel, Thomas	CDU/CSU	Politikwissenschaftler
Radomski, Kerstin	CDU/CSU	Lehrerin
Radwan, Alexander	CDU/CSU	Diplom-Ingenieur
Raffelhüschen, Claudia	FDP	Volkswirtin
Rainer, Alois	CDU/CSU	Metzgermeister
Ramsauer, Dr. Peter	CDU/CSU	Müllermeister / Diplom-Kaufmann
Redder, Dr. Volker	FDP	Unternehmer
Rehbaum, Henning	CDU/CSU	Diplom-Betriebswirt (FH)
Reichardt, Martin	AfD	Offizier
Reichel, Dr. Markus	CDU/CSU	Diplom-Mathematiker
Reichinnek, Heidi	Die Linke	pädagogische Mitarbeiterin Jugendhilfe
Reinalter, Prof. Dr. Anja	Grüne	Professorin für Soziale Arbeit
Reinhold, Hagen	FDP	Meister im Maurer- und Betonhandwerk
Renner, Martina	Die Linke	
Renner, Martin Erwin	AfD	Diplom-Betriebswirt
Reuther, Bernd	FDP	Diplom-Sozialwissenschaftler
Rhie, Ye-One	SPD	Kommunikationswissenschaftlerin
Rief, Josef	CDU/CSU	Landwirtschaftsmeister
Riexinger, Bernd	Die Linke	Bankkaufmann
Rimkus, Andreas	SPD	Elektromeister in der Energiewirtschaft
Rinck, Frank	AfD	Landwirt
Rix, Sönke	SPD	Erzieher
Rohde, Dennis	SPD	Rechtsanwalt
Rohwer, Lars	CDU/CSU	Bankkaufmann
Roloff, Sebastian	SPD	Rechtsanwalt
Rosemann, Dr. Martin	SPD	Diplom-Volkswirt
Rosenthal, Jessica	SPD	Gesamtschullehrerin
Rößner, Tabea	Grüne	Journalistin
Roth (Augsburg), Claudia	Grüne	
Roth (Heringen), Michael	SPD	Diplom-Politologe
Röttgen, Dr. Norbert	CDU/CSU	Rechtsanwalt
Rottmann, Dr. Manuela	Grüne	Juristin
Rouenhoff, Stefan	CDU/CSU	Diplom-Volkswirt
Röwekamp, Thomas	CDU/CSU	Rechtsanwalt,  Notar
Rüddel, Erwin	CDU/CSU	Diplom-Betriebswirt
Rudolph, Dr. Thorsten	SPD	Beamter
Rudolph, Tina	SPD	Ärztin
Rüffer, Corinna	Grüne	
Rupprecht, Albert	CDU/CSU	Diplom-Volkswirt
Rützel, Bernd	SPD	
Ryglewski, Sarah	SPD	Diplom-Politikwissenschaftlerin
Saathoff, Johann	SPD	Diplom-Verwaltungswirt (FH)
Saleh, Kassem Taher	Grüne	Diplom-Bauingenieur
Santos Firnhaber, Catarina dos	CDU/CSU	Rechtsanwältin
Sattelberger, Dr. h. c. Thomas	FDP	Diplom-Betriebswirt
Sauter, Christian	FDP	Diplom-Wirtschaftsingenieur (FH)
Schäfer (Bochum), Axel	SPD	
Schäfer, Dr. Sebastian	Grüne	Ministerialbeamter
Schäfer, Ingo	SPD	Feuerwehrmann
Schäfer, Jamila	Grüne	Studentin der Soziologie
Schäffler, Frank	FDP	Diplom-Betriebswirt (FH)
Schamber, Rebecca	SPD	Dipl.-Juristin
Schattner, Bernd	AfD	geschäftsführender Gesellschafter
Schätzl, Johannes	SPD	Informatiker
Schäuble, Dr. Wolfgang	CDU/CSU	
Schauws, Ulle	Grüne	Film- und Fernsehwissenschaftlerin
Scheer, Dr. Nina	SPD	Juristin / Politikwissenschaftlerin / Musikerin
Schenderlein, Dr. Christiane	CDU/CSU	Politikwissenschaftlerin
Scheuer, Andreas	CDU/CSU	
Schieder, Marianne	SPD	Juristin
Schiefner, Udo	SPD	
Schielke-Ziesing, Ulrike	AfD	Verwaltungswirtin
Schierenbeck, Peggy	SPD	Coach Führung und Verantwortung
Schimke, Jana	CDU/CSU	Diplom-Politikwissenschaftlerin
Schisanowski, Timo	SPD	Wirtschaftsjurist
Schmid, Christoph	SPD	
Schmid, Dr. Nils	SPD	Jurist
Schmidt, Eugen	AfD	Diplom-Informatiker
Schmidt, Jan Wenzel	AfD	Handelsfachwirt
Schmidt, Stefan	Grüne	Lehrer
Schmidt, Uwe	SPD	Hafenfacharbeiter
Schmidt (Wetzlar), Dagmar	SPD	Historikerin
Schneider, Daniel	SPD	Kulturveranstalter
Schneider (Erfurt), Carsten	SPD	Bankkaufmann
Schneider, Jörg	AfD	Diplom-Ingenieur Maschinenbau
Schnieder, Patrick	CDU/CSU	Bürgermeister a. D. 
Scholz, Olaf	SPD	Rechtsanwalt
Schönberger, Marlene	Grüne	Politikwissenschaftlerin (M. A.)
Schön, Nadine	CDU/CSU	
Schraps, Johannes	SPD	Politikwissenschaftler (M.A.)
Schreider, Christian	SPD	Jurist
Schreiner, Felix	CDU/CSU	
Schröder, Christina-Johanne	Grüne	Politikreferentin
Schröder, Ria	FDP	Juristin
Schrodi, Michael	SPD	Gymnasiallehrer
Schulz, Anja	FDP	Finanzberaterin
Schulz-Asche, Kordula	Grüne	Kommunikationswissenschaftlerin
Schulze, Svenja	SPD	
Schulz, Uwe	AfD	
Schwabe, Frank	SPD	
Schwartze, Stefan	SPD	Industriemechaniker
Schwarz, Andreas	SPD	Diplom-Betriebswirt (FH)
Schwarz, Armin	CDU/CSU	Lehrer
Schwarzelühr-Sutter, Rita	SPD	Diplom-Betriebswirtin
Seestern-Pauly, Matthias	FDP	Gymnasiallehrer
Seidler, Stefan	fraktionslos	Deutsch-Dänischer Koordinator
Seif, Detlef	CDU/CSU	Rechtsanwalt
Seiter, Prof. Dr. Stephan	FDP	Professor für Volkswirtschaftslehre
Seitzl, Dr. Lina	SPD	Politikwissenschaftlerin
Seitz, Thomas	AfD	Volljurist
Sekmen, Melis	Grüne	Studentin der Volkswirtschaftslehre
Semet, Rainer	FDP	Wirtschaftsingenieur
Sichert, Martin	AfD	Diplom-Kaufmann
Silberhorn, Thomas	CDU/CSU	Rechtsanwalt
Simon, Björn	CDU/CSU	Politikwissenschaftler
Sitte, Dr. Petra	Die Linke	Diplom-Ökonomin
Skudelny, Judith	FDP	Rechtsanwältin
Slawik, Nyke	Grüne	Wissenschaftliche Mitarbeiterin
Sorge, Tino	CDU/CSU	Rechtsanwalt
Spahn, Jens	CDU/CSU	Bankkaufmann; Politologe
Spallek, Dr. Anne Monika	Grüne	Unternehmensberaterin/ Leiterin eines Pferdebetriebes
Spaniel, Dr. Dirk	AfD	Diplom-Ingenieur
Spellerberg, Merle	Grüne	Studentin
Springer, René	AfD	Politikwissenschaftler
Stadler, Svenja	SPD	Senior-PR-Beraterin
Staffler, Katrin	CDU/CSU	Biochemikerin (M. Sc.)
Stahr, Nina	Grüne	Lehrerin
Stamm-Fibich, Martina	SPD	Marketing- und Kommunikationsmanagerin
Stark-Watzinger, Bettina	FDP	Diplom-Volkswirtin
Steffen, Dr. Till	Grüne	Rechtsanwalt
Stefinger, Dr. Wolfgang	CDU/CSU	Betriebswirt
Stegemann, Albert	CDU/CSU	Landwirtschaftsmeister
Stegner, Dr. Ralf	SPD	Politikwissenschaftler
Steiniger, Johannes	CDU/CSU	Gymnasiallehrer
Stein, Mathias	SPD	Bautechniker
Steinmüller, Hanna	Grüne	Wissenschaftliche Mitarbeiterin
Stetten, Christian Freiherr von	CDU/CSU	Diplom-Betriebswirt (FH)
Sthamer, Nadja	SPD	Wiasenschaftliche Mitarbeiterin
Stier, Dieter	CDU/CSU	Diplom-Agraringenieur
Stöber, Klaus	AfD	Steuerberater
Stöcker, Diana	CDU/CSU	Bürgermeisterin
Stockmeier, Konrad	FDP	Marktforscher
Storch, Beatrix von	AfD	Rechtsanwältin
Storjohann, Gero	CDU/CSU	Diplom-Betriebswirt (FH)
Stracke, Stephan	CDU/CSU	
Strack-Zimmermann, Dr. Marie-Agnes	FDP	Publizistin (M.A.)
Strasser, Benjamin	FDP	Rechtsanwalt
Straubinger, Max	CDU/CSU	Landwirtschaftsmeister
Strengmann-Kuhn, Dr. Wolfgang	Grüne	Volkswirt
Stumpp, Christina	CDU/CSU	Verwaltungswirtin und Steuerrechtlerin LL.B.
Stüwe, Ruppert	SPD	Diplom-Volkswirt
Tatti, Jessica	Die Linke	Sozialarbeiterin (B.A.)
Tausend, Claudia	SPD	Diplom-Geografin
Tebroke, Dr. Hermann-Josef	CDU/CSU	Diplom-Kaufmann
Tesfaiesus, Awet	Grüne	Rechtsanwältin
Teuteberg, Linda	FDP	Rechtsanwältin
Teutrine, Jens	FDP	Student
Theurer, Michael	FDP	Diplom-Volkswirt
Thews, Michael	SPD	Diplom-Chemieingenieur
Thies, Hans-Jürgen	CDU/CSU	Rechtsanwalt
Thomae, Stephan	FDP	Rechtsanwalt
Throm, Alexander	CDU/CSU	Rechtsanwalt
Tillmann, Antje	CDU/CSU	Diplom-Finanzwirtin
Timmermann-Fechter, Astrid	CDU/CSU	Referentin
Tippelt, Nico	FDP	Diplom-Musikpädagoge
Todtenhausen, Manfred	FDP	Elektromeister
Toncar, Dr. Florian	FDP	Rechtsanwalt
Töns, Markus	SPD	Politologe
Träger, Carsten	SPD	Diplom-Kommunikationswirt (BAW)
Trittin, Jürgen	Grüne	Diplom-Sozialwirt
Troff-Schaffarzyk, Anja	SPD	Diplom-Pädagogin
Türk-Nachbaur, Derya	SPD	pädagogische Fachkraft
Uhlig, Katrin	Grüne	wissenschaftliche Referentin
Uhl, Markus	CDU/CSU	Diplom-Kaufmann
Ullmann, Prof. Dr. Andrew	FDP	Facharzt für Innere Medizin, Universitätsprofessor 
Ullrich, Dr. Volker	CDU/CSU	
Ullrich, Frank	SPD	Diplom-Sportlehrer (Trainer)
Ullrich, Gerald	FDP	Ingenieur
Ulrich, Alexander	Die Linke	
Verlinden, Dr. Julia	Grüne	Diplom-Umweltwissenschaftlerin
Vieregge, Kerstin	CDU/CSU	Betriebswirtin
Vogel (Olpe), Johannes	FDP	Politikwissenschaftler
Vogler, Kathrin	Die Linke	Geschäftsführerin
Vogt, Dr. Oliver	CDU/CSU	Diplom-Physiker
Völlers, Marja-Liisa	SPD	Gymnasiallehrerin
Vöpel, Dirk	SPD	Selbständiger Kaufmann
Vries, Christoph de	CDU/CSU	Diplom-Soziologe
Wadephul, Dr. Johann David	CDU/CSU	Rechtsanwalt
Wagener, Niklas	Grüne	Student der Forstwirtschaft
Wagener, Robin	Grüne	Richter
Wagenknecht, Dr. Sahra	Die Linke	
Wagner, Dr. Carolin	SPD	Referatsleiterin
Wagner, Johannes	Grüne	Assistenzarzt
Wallstein, Maja	SPD	Wissenschaftsmanagerin
Walter, Hannes	SPD	Betriebswirt
Walter-Rosenheimer, Beate	Grüne	Diplom-Psychologin
Wanderwitz, Marco	CDU/CSU	Rechtsanwalt
Warken, Nina	CDU/CSU	Rechtsanwältin
Weeser, Sandra	FDP	Betriebswirtin VWA
Wegge, Carmen	SPD	Juristin
Wegling, Melanie	SPD	Managerin im strategischen Vertrieb
Weidel, Dr. Alice	AfD	Diplom-Kauffrau, Diplom-Volkswirtin
Weingarten, Dr. Joe	SPD	Diplom-Verwaltungswissenschaftler
Weisgerber, Dr. Anja	CDU/CSU	Rechtsanwältin
Weishaupt, Saskia	Grüne	Politikwissenschaftlerin
Weiss, Maria-Lena	CDU/CSU	Rechtsanwältin
Weiss (Wesel I), Sabine	CDU/CSU	Rechtsanwältin
Wenzel, Stefan	Grüne	Agraringenieur
Werner, Lena	SPD	Projektmanagerin
Westig, Nicole	FDP	Fundraiserin
Westphal, Bernd	SPD	Chemielaborant
Weyel, Prof. Dr. Harald	AfD	Professor der Betriebswirtschaft
Whittaker, Kai	CDU/CSU	Wirtschaftswissenschaftler (M. Sc.)
Widmann-Mauz, Annette	CDU/CSU	
Wiehle, Wolfgang	AfD	Diplom-Informatiker
Wiener, Dr. Klaus	CDU/CSU	Volkswirt
Wiese, Dirk	SPD	Jurist
Willsch, Klaus-Peter	CDU/CSU	Diplom-Volkswirt
Winkelmeier-Becker, Elisabeth	CDU/CSU	Richterin
Winkler, Tobias	CDU/CSU	Leiter des Verbindungsbüros des Europäischen Parlaments
Winklmann, Tina	Grüne	Verfahrensmechanikerin für Kunststoff- und Kautschuktechnik
Wirth, Dr. Christian	AfD	Rechtsanwalt
Wissing, Dr. Volker	FDP	Rechtsanwalt
Wissler, Janine	Die Linke	Diplom-Politikwissenschaftlerin
Wittmann, Mechthilde	CDU/CSU	Juristin
Witt, Uwe	AfD	Diplom-Personalbetriebswirt
Wollmann, Dr. Herbert	SPD	Arzt
Wulf, Mareike Lotte	CDU/CSU	Geschäftsführerin
Wundrak, Joachim	AfD	Beamter i. R.
Yüksel, Gülistan	SPD	Apothekenhelferin (jetzt PKA)
Zeulner, Emmi	CDU/CSU	Examinierte Gesundheits- und Krankenpflegerin 
Ziegler, Kay-Uwe	AfD	Kaufmann,  Geschäftsführer
Ziemiak, Paul	CDU/CSU	
Zierke, Stefan	SPD	Werkzeugmacher/ Reiseverkehrskaufmann/ Tourismusfachwirt
Zimmermann, Dr. Jens	SPD	Diplom-Kaufmann
Zippelius, Nicolas	CDU/CSU	Politikwissenschaftler (B. A.)
Zorn, Armand	SPD	Projektleiter
Zschau, Katrin	SPD	Landesgeschäftsführerin
